1111111111111
1CC100CCCCCC1
1CCCC11111CC1
1P0C11ECCCCC1
1111111111111
